1111111111111111111
1C010000000C00000C1
1CP00111110000000C1
1C010000000C00000C1
1C010000C00C00000C1
1C010000000C00000C1
1C010000000C00000C1
1C0011E0000000000C1
1111111111111111111