1111111111111111111
1C010000000C00000C1
1CP00111110000000C1
1C010000000C00000C1
1C010000C00C000B0C1
1C0100P0000C00000C1
1C010000C00C000B0C1
1C010000000C00000C1
1C010000C00C000B0C1
1C010000C00C000B0C1
1C010000000C00000C1
1C010000C00C000B0C1
1C01000B000C00000C1
1C010000000C000B0C1
1C0011E0000000000C1
1111111111111111111